[
"#..............................#",
"#..............................#",
"#..............................#",
"#..............................#",
"#..............................#",
"#..............................#",
"#..............................#",
"#..............................#",
"#..............................#",
"#..............................#",
"#..............................#",
"#..............................#",
"#.....##.........#..........####",
"#................#.............#",
"#.......###......#......##.....#",
"#...............################",
"#..........###.................#",
"#..............................#",
"#########......................#",
"#..............................#",
"################################"
]
