[
"#....###########################",
"#....#.........................#",
"#....#.........................#",
"#...##.........................#",
"#....#.........................#",
"#....#.........................#",
"#....#.........................#",
"#....#.........................#",
"#....#.........................#",
"#....#.........................#",
"##...#...#############.........#",
"#....#...#############.........#",
"#....#...#############.........#",
"#....#...#############.........#",
"#........#############.........#",
"#........##############........#",
"#........##############......###",
"#........##############........#",
"#######################........#",
"#.....................#........#",
"#.....................#........#",
"#.....................#........#",
"#.....................#........#",
"#.....................#........#",
"#.....................##.......#",
"#.....................##.......#",
"#.....................##.......#",
"#.....................##.......#",
"#.....................##.......#",
"#.....................##.......#",
"#................#....##....####",
"#................#.............#",
"#................#.............#",
"#................#.............#",
"#................#.............#",
"#................#......##.....#",
"#...............################",
"#..............................#",
"#..............................#",
"#..............................#",
"#..........###.................#",
"#..............................#",
"#..............................#",
"#..............................#",
"#..............................#",
"#########......................#",
"#..............................#",
"#..............................#",
"#..............................#",
"#..............................#",
"#..............................#",
"#..............................#",
"################################"
]